Ace In The Hole	Survivor	iconPerks_aceInTheHole	75
Adrenaline	Survivor	iconPerks_adrenaline	175
Aftercare	Survivor	iconPerks_aftercare	175
Agitation	Killer	iconPerks_agitation	50
Alert	Survivor	iconPerks_alert	125
A Nurse's Calling	Killer	iconPerks_aNursesCalling	125
Autodidact	Survivor	iconPerks_autodidact	25
Balanced Landing	Survivor	iconPerks_balancedLanding	150
Bamboozle	Killer	iconPerks_bamboozle	125
Barbecue & Chilli	Killer	iconPerks_BBQAndChili	200
Beast Of Prey	Killer	iconPerks_BeastOfPrey	10
Bitter Murmur	Killer	iconPerks_bitterMurmur	50
Bloodhound	Killer	iconPerks_bloodhound	75
Blood Warden	Killer	iconPerks_bloodWarden	75
Boil Over	Survivor	iconPerks_boilOver	10
Bond	Survivor	iconPerks_bond	125
Borrowed Time	Survivor	iconPerks_borrowedTime	125
Botany Knowledge	Survivor	iconPerks_botanyKnowledge	50
Breakdown	Survivor	iconPerks_breakdown	10
Brutal Strength	Killer	iconPerks_brutalStrength	100
Calm Spirit	Survivor	iconPerks_calmSpirit	10
Coulrophobia	Killer	iconPerks_coulrophobia	25
Dance With Me	Survivor	iconPerks_danceWithMe	100
Dark Sense	Survivor	iconPerks_darkSense	25
Dead Hard	Survivor	iconPerks_DeadHard	200
Decisive Strike	Survivor	iconPerks_decisiveStrike	150
Deerstalker	Killer	iconPerks_deerstalker	50
Deja Vu	Survivor	iconPerks_dejaVu	1
Deliverance	Survivor	iconPerks_deliverance	125
Detective's Hunch	Survivor	iconPerks_detectivesHunch	10
Discordance	Killer	iconPerks_discordance	100
Distortion	Survivor	iconPerks_distortion	50
Distressing	Killer	iconPerks_distressing	10
Diversion	Survivor	iconPerks_diversion	150
Dying Light	Killer	iconPerks_dyingLight	10
Empathy	Survivor	iconPerks_empathy	75
Enduring	Killer	iconPerks_enduring	175
Fire Up	Killer	iconPerks_fireUp	5
Franklin's Demise	Killer	iconPerks_franklinsLoss	75
Hangman's Trick	Killer	iconPerks_hangmansTrick	1
Hex Devour Hope	Killer	iconPerks_devourHope	100
Hex Haunted Ground	Killer	iconPerks_hauntedGround	75
Hex Huntress Lullaby	Killer	iconPerks_HuntressLullaby	25
Hex No One Escapes Death	Killer	iconPerks_noOneEscapesDeath	150
Hex Ruin	Killer	iconPerks_ruin	200
Hex The Third Seal	Killer	iconPerks_theThirdSeal	10
Hex Thrill Of The Hunt	Killer	iconPerks_thrillOfTheHunt	50
Hope	Survivor	iconPerks_hope	100
Insidious	Killer	iconPerks_insidious	50
Iron Grasp	Killer	iconPerks_ironGrasp	25
Iron Maiden	Killer	iconPerks_ironMaiden	25
Iron Will	Survivor	iconPerks_ironWill	150
Kindred	Survivor	iconPerks_kindred	75
Knock Out	Killer	iconPerks_knockOut	50
Leader	Survivor	iconPerks_leader	25
Left Behind	Survivor	iconPerks_leftBehind	5
Lightborn	Killer	iconPerks_lightborn	25
Lightweight	Survivor	iconPerks_lightweight	50
Lithe	Survivor	iconPerks_lithe	125
Mad Grit	Killer	iconPerks_madGrit	5
Make Your Choice	Killer	iconPerks_makeYourChoice	100
Monitor & Abuse	Killer	iconPerks_monitorAndAbuse	125
Monstrous Shrine	Killer	iconPerks_monstrousShrine	1
No Mither	Survivor	iconPerks_NoMither	10
No One Left Behind	Survivor	iconPerks_noOneLeftBehind	1
Object Of Obsession	Survivor	iconPerks_objectOfObsession	25
Open-Handed	Survivor	iconPerks_openHanded	5
Overcharge	Killer	iconPerks_generatorOvercharge	50
Overwhelming Presence	Killer	iconPerks_overwhelmingPresence	1
Pharmacy	Survivor	iconPerks_pharmacy	75
Play With Your Food	Killer	iconPerks_playWithYourFood	50
Plunderer's Instinct	Survivor	iconPerks_plunderersInstinct	100
Pop Goes The Weasel	Killer	iconPerks_popGoesTheWeasel	125
Predator	Killer	iconPerks_predator	5
Premonition	Survivor	iconPerks_premonition	25
Prove Thyself	Survivor	iconPerks_proveThyself	50
Quick & Quiet	Survivor	iconPerks_quickAndQuiet	150
Rancor	Killer	iconPerks_hatred	50
Remember Me	Killer	iconPerks_rememberMe	100
Resilience	Survivor	iconPerks_resilience	50
Saboteur	Survivor	iconPerks_saboteur	50
Save The Best For Last	Killer	iconPerks_saveTheBestForLast	75
Self-Care	Survivor	iconPerks_selfCare	200
Shadowborn	Killer	iconPerks_shadowborn	100
Slippery Meat	Survivor	iconPerks_slipperyMeat	25
Sloppy Butcher	Killer	iconPerks_sloppyButcher	150
Small Game	Survivor	iconPerks_smallGame	50
Sole Survivor	Survivor	iconPerks_soleSurvivor	5
Spies From The Shadows	Killer	iconPerks_spiesFromTheShadows	75
Spine Chill	Survivor	iconPerks_spineChill	50
Spirit Fury	Killer	iconPerks_spiritFury	100
Sprint Burst	Survivor	iconPerks_sprintBurst	100
Stake Out	Survivor	iconPerks_stakeOut	5
Streetwise	Survivor	iconPerks_streetwise	1
Stridor	Killer	iconPerks_stridor	75
Surveillance	Killer	iconPerks_surveillance	10
Technician	Survivor	iconPerks_technician	50
Tenacity	Survivor	iconPerks_tenacity	100
Territorial Imperative	Killer	iconPerks_TerritorialImperative	25
Thanatophobia	Killer	iconPerks_thatanophobia	75
This Is Not Happening	Survivor	iconPerks_thisIsNotHappening	1
Tinkerer	Killer	iconPerks_tinkerer	50
Unbreakable	Survivor	iconPerks_unbreakable	125
Unnerving Presence	Killer	iconPerks_unnervingPresence	5
Unrelenting	Killer	iconPerks_unrelenting	5
Up The Ante	Survivor	iconPerks_upTheAnte	5
Urban Evasion	Survivor	iconPerks_urbanEvasion	150
Vigil	Survivor	iconPerks_vigil	5
Wake Up!	Survivor	iconPerks_wakeUp	5
We'll Make It	Survivor	iconPerks_wellMakeIt	75
We're Gonna Live Forever	Survivor	iconPerks_WereGonnaLiveForever	50
Whispers	Killer	iconPerks_whispers	175
Windows Of Opportunity	Survivor	iconPerks_windowsOfOpportunity	75
